1111111111
1000000001
1002003001
1000000001
1000300001
1000000001
1000000201
1020000001
1000000301
1111111111