1111111111
1000000001
1001001001
1000000001
1000100001
1000000001
1000000101
1010000001
1000000101
1111111111